22 40
06 50 120
9 9 9 9 9 9 9 9 9 9 9 9 9 9 9 9 9 9 9 9 9 9 9 9 9 9 9 9 9 9 9 9 9 9 9 9 9 9 9 9
9 3 1 3 4 1 3 3 3 1 2 1 1 1 4 3 3 1 1 3 2 1 1 1 4 1 1 1 3 1 2 1 1 1 4 3 1 3 1 9 
9 1 1 1 0 1 3 1 3 1 2 1 1 1 3 0 3 1 1 3 2 3 1 1 1 1 3 1 1 3 2 3 1 1 1 3 1 3 3 9 
9 1 1 1 1 0 1 1 3 3 2 1 3 1 1 1 1 3 1 1 2 1 1 3 1 0 3 3 1 1 2 1 1 1 1 3 1 3 3 9 
9 3 1 3 1 1 0 3 3 3 2 1 3 1 1 1 1 0 1 1 2 3 1 1 1 1 1 1 3 1 2 3 1 1 1 1 1 1 3 9 
9 3 1 0 1 1 1 3 1 1 2 1 0 0 1 1 3 1 3 3 2 1 1 1 1 1 1 1 3 1 2 3 1 1 1 1 1 1 0 9 
9 3 3 1 1 3 1 1 1 1 2 1 1 1 3 1 1 1 1 1 2 3 1 3 3 1 1 1 1 1 2 3 1 1 3 0 3 1 1 9
9 1 1 3 1 3 3 1 1 3 2 3 3 1 1 1 3 1 1 1 2 3 1 3 3 1 1 1 1 1 2 3 1 1 3 1 0 1 2 9 
9 1 1 3 1 1 1 3 1 1 2 1 1 1 3 1 3 1 1 3 2 3 1 1 3 1 0 1 3 3 2 1 0 3 1 1 6 2 3 9 
9 3 1 3 1 2 2 2 2 2 2 2 2 2 6 2 2 2 2 2 2 2 2 2 3 2 2 2 2 2 2 2 2 2 1 1 2 1 0 9 
9 1 3 1 0 0 1 1 1 1 1 3 3 3 3 1 1 3 1 3 1 3 3 1 1 3 3 1 1 1 0 3 1 1 3 2 3 1 1 9 
9 3 1 3 3 1 1 1 1 1 1 3 3 3 3 1 1 3 1 0 1 0 3 1 1 1 3 1 1 3 1 3 3 1 2 3 1 3 3 9 
9 1 0 1 3 1 3 1 0 2 1 1 3 3 3 1 1 3 1 1 1 1 0 1 1 1 3 1 1 1 1 1 3 2 1 3 1 3 3 9 
9 1 0 1 3 1 3 1 0 2 3 1 2 2 2 2 2 2 2 2 2 2 2 2 2 2 2 2 2 3 3 1 2 1 1 3 1 1 1 9 
9 3 1 1 0 3 3 3 1 2 3 1 1 1 1 3 1 1 1 3 1 1 1 0 1 3 3 1 1 1 1 2 1 3 1 3 3 1 3 9 
9 3 1 1 1 3 3 3 1 2 3 1 3 1 1 1 0 3 1 1 3 1 3 1 1 1 3 1 3 3 2 1 1 1 1 1 3 1 11 9 
9 0 1 3 1 1 1 1 3 2 0 0 1 1 3 1 3 3 3 1 1 1 1 1 1 1 3 1 3 2 1 1 1 1 1 1 0 1 1 9 
9 1 1 3 1 1 1 1 0 2 1 1 3 1 1 1 1 1 1 3 1 3 3 1 1 1 1 1 2 3 1 1 3 1 3 1 1 1 3 9 
9 3 1 3 3 1 1 3 1 2 3 1 1 1 3 1 1 1 1 3 8 3 3 1 1 1 1 1 1 3 1 1 3 6 1 1 3 1 1 9 
9 3 1 1 1 3 1 1 1 2 1 1 3 1 3 6 1 1 1 1 1 1 3 1 1 1 0 3 1 1 0 3 1 1 3 4 3 1 1 9 
9 3 3 1 4 1 0 1 1 2 1 1 3 1 3 3 1 1 1 1 1 1 3 1 1 3 1 0 3 1 6 1 3 3 1 3 1 1 1 9 
9 9 9 9 9 9 9 9 9 9 9 9 9 9 9 9 9 9 9 9 9 9 9 9 9 9 9 9 9 9 9 9 9 9 9 9 9 9 9 9 

//linhas, colunas, meta de diamantes,ponto por diamantes,tempo

//0 tunel
//1 terra
//2 muro
//3 pedra
//4 diamante
//5 amoeba
//6 vagalume
//7 borboleta
//8 player
//9 borda
//10 muro magico
//11 saida
