22 40
10 20 150
9 9 9 9 9 9 9 9 9 9 9 9 9 9 9 9 9 9 9 9 9 9 9 9 9 9 9 9 9 9 9 9 9 9 9 9 9 9 9 9 
9 1 3 1 1 3 1 1 2 1 3 1 1 1 4 1 2 1 1 1 0 1 3 1 2 0 1 1 1 1 1 1 2 1 1 3 3 1 1 9 
9 1 1 1 1 1 1 1 2 1 1 1 1 1 1 0 2 0 0 1 0 1 1 1 2 0 1 1 0 1 1 1 2 1 1 1 1 0 1 9 
9 0 0 0 0 0 0 0 0 0 0 0 0 0 0 3 0 3 3 0 0 0 0 0 0 3 0 0 4 0 0 0 0 0 0 0 0 3 0 9 
9 4 1 1 1 1 1 1 2 1 3 1 1 1 1 3 2 1 3 1 0 1 1 0 2 1 1 3 1 1 4 1 2 1 1 3 1 3 1 9 
9 1 1 1 1 1 1 1 2 1 3 1 1 1 1 3 2 1 3 1 0 3 1 1 2 1 1 1 1 1 3 1 2 1 1 1 0 1 1 9 
9 2 2 2 2 2 2 2 2 2 2 2 2 2 2 2 2 2 2 2 0 2 2 2 2 2 2 2 2 2 2 2 2 2 2 2 2 2 2 9 
9 1 1 1 1 3 3 1 2 1 1 0 1 1 1 1 2 1 1 1 0 1 1 3 2 1 1 1 1 0 1 1 2 1 1 1 1 1 3 9 
9 1 1 1 1 1 1 1 2 1 1 0 1 1 1 1 2 1 1 1 0 1 1 1 2 1 1 1 1 3 1 0 2 1 1 1 1 1 3 9 
9 0 0 0 0 0 0 0 0 0 0 3 0 0 0 0 0 0 0 0 0 0 0 0 0 0 0 0 0 3 0 0 0 0 0 0 0 0 0 9 
9 3 1 1 3 1 1 1 2 1 1 1 1 3 1 1 2 1 1 3 0 1 1 1 2 1 1 1 1 1 1 4 2 0 1 1 1 1 1 9 
9 3 1 1 1 1 3 1 2 1 1 3 1 1 3 1 2 1 1 1 0 1 0 3 2 1 1 1 1 1 1 1 2 3 1 1 1 3 1 9 
9 1 3 1 1 1 1 1 2 1 1 1 3 1 1 1 2 1 1 1 0 1 0 3 2 1 1 1 1 1 1 1 2 3 3 1 1 3 1 9 
9 2 2 2 2 2 2 2 2 2 2 2 2 2 2 2 2 2 2 2 0 2 2 2 2 2 2 2 2 2 2 2 2 2 2 2 2 2 2 9 
9 3 1 0 0 6 1 1 2 1 1 1 1 3 1 3 2 1 1 1 0 1 1 1 2 1 3 4 1 1 3 1 2 1 1 1 1 1 1 9 
9 1 1 1 1 1 0 1 2 0 1 1 1 1 1 1 2 1 1 0 0 1 1 1 2 0 1 1 0 1 1 1 2 1 0 1 0 0 1 9 
9 0 0 0 0 0 0 0 0 3 0 0 0 0 0 0 0 0 0 4 0 0 0 0 0 0 0 0 3 0 0 0 0 0 3 0 3 3 0 9 
9 4 1 1 0 1 3 1 2 3 1 1 1 1 3 1 2 1 3 1 0 1 1 3 2 1 3 1 3 1 1 1 2 1 1 1 1 1 1 9 
9 1 1 1 1 1 3 1 2 3 1 1 4 1 1 1 2 1 1 1 0 0 1 1 2 1 1 3 1 1 1 1 2 1 1 1 0 0 0 9 
9 1 4 1 1 1 3 0 2 1 1 0 1 1 1 1 2 1 8 4 3 3 1 1 2 1 0 1 1 1 1 1 2 1 1 1 3 3 3 9 
9 1 3 1 1 1 1 3 2 1 1 3 1 1 3 1 2 1 11 1 3 1 1 1 2 1 1 1 1 3 1 3 2 1 1 1 1 3 1 9 
9 9 9 9 9 9 9 9 9 9 9 9 9 9 9 9 9 9 9 9 9 9 9 9 9 9 9 9 9 9 9 9 9 9 9 9 9 9 9 9 

//linhas, colunas, meta de diamantes,ponto por diamantes,tempo

//0 tunel
//1 terra
//2 muro
//3 pedra
//4 diamante
//5 amoeba
//6 vagalume
//7 borboleta
//8 player
//9 borda
//10 muro magico
//11 saida
