22 40
75 5 150
9 9 9 9 9 9 9 9 9 9 9 9 9 9 9 9 9 9 9 9 9 9 9 9 9 9 9 9 9 9 9 9 9 9 9 9 9 9 9 9 
9 4 4 4 3 3 4 4 3 4 4 3 1 3 3 3 3 4 3 4 4 1 4 4 3 4 4 3 4 4 4 4 3 3 4 3 4 3 3 9 
9 4 3 3 4 4 4 3 3 3 4 3 4 4 3 3 3 3 3 3 4 3 3 4 1 4 3 4 3 3 3 3 4 3 4 4 3 3 4 9 
9 4 4 3 3 3 3 3 3 3 4 3 4 4 3 3 1 3 3 3 4 3 3 4 4 4 3 4 3 1 3 3 4 3 3 3 4 4 3 9 
9 3 3 4 3 4 4 3 3 3 3 3 3 4 3 3 4 4 4 1 1 4 4 3 3 4 3 4 4 3 3 4 3 4 4 1 3 3 4 9 
9 3 3 4 3 4 4 3 3 3 3 3 3 4 3 3 4 1 4 3 4 3 3 3 3 4 3 4 3 4 3 3 4 4 3 3 4 3 4 9 
9 4 4 4 3 3 4 3 4 1 4 4 3 3 4 4 3 3 4 4 4 3 3 4 3 4 3 3 3 1 4 3 4 4 3 3 4 3 4 9 
9 3 3 3 3 3 4 3 3 4 4 4 4 1 1 3 3 3 4 3 4 4 1 3 4 3 4 4 3 1 3 3 4 4 4 4 4 4 3 9 
9 4 3 4 4 2 2 2 2 2 2 2 1 2 2 2 2 2 4 3 3 3 3 4 3 2 2 2 2 2 2 1 2 2 2 2 2 2 3 9 
9 4 1 4 4 2 0 0 0 0 0 0 0 0 0 0 0 2 3 4 4 3 3 3 4 2 0 0 0 0 0 0 0 0 0 0 0 2 3 9
9 4 3 4 3 2 0 8 11 0 0 0 0 0 0 0 0 2 3 4 4 3 3 3 4 2 0 0 0 0 0 0 0 0 0 0 0 2 3 9 
9 4 3 3 4 2 0 0 0 0 0 0 0 0 0 0 0 2 3 1 3 3 4 4 3 2 0 0 0 0 0 0 0 0 0 0 0 2 3 9 
9 4 3 3 4 2 0 0 0 0 0 0 0 0 0 0 0 2 4 4 4 4 3 4 3 2 0 0 0 0 0 0 0 0 0 0 0 2 4 9 
9 3 4 4 4 2 0 0 0 0 0 0 0 0 0 0 0 2 4 3 3 4 1 4 3 2 0 0 0 0 0 0 0 0 0 0 0 2 4 9 
9 3 3 3 3 2 0 0 0 0 0 0 0 0 0 0 0 2 4 3 3 4 4 3 3 2 0 0 0 0 0 0 0 0 0 0 0 2 3 9 
9 4 3 4 4 2 0 0 0 0 0 0 0 0 0 0 0 2 1 3 4 3 3 4 3 2 0 0 0 0 0 0 0 0 0 0 0 2 3 9 
9 4 3 4 4 2 0 0 0 0 0 0 0 0 0 0 0 2 2 2 2 2 2 2 2 2 0 0 0 0 0 0 0 0 0 0 0 2 3 9 
9 3 3 3 4 2 0 0 0 0 0 0 0 0 0 0 0 0 0 0 0 0 0 0 0 0 0 0 0 0 0 0 0 0 0 0 0 2 3 9 
9 3 3 3 4 2 0 0 0 0 0 0 0 0 0 0 0 2 4 4 1 3 4 3 4 2 0 0 0 0 0 0 0 0 0 0 0 2 3 9 
9 4 4 3 3 2 0 0 0 0 0 0 0 0 0 0 0 2 3 3 3 4 3 4 4 2 0 0 0 0 0 0 0 0 0 0 0 2 3 9 
9 4 4 1 1 2 2 2 2 2 2 2 2 2 2 2 2 2 4 3 3 3 4 4 4 2 2 2 2 2 2 2 2 2 2 2 2 2 4 9 
9 9 9 9 9 9 9 9 9 9 9 9 9 9 9 9 9 9 9 9 9 9 9 9 9 9 9 9 9 9 9 9 9 9 9 9 9 9 9 9 

//linhas, colunas, meta de diamantes,ponto por diamantes,tempo

//0 tunel
//1 terra
//2 muro
//3 pedra
//4 diamante
//5 amoeba
//6 vagalume
//7 borboleta
//8 player
//9 borda
//10 muro magico
//11 saida
